TOKENS	POS
The	DT
journey	NN
took	VBD
him	PRP
to	TO
Dakar	NNP
,	,
the	DT
capital	NN
city	NN
of	IN
Senegal	NNP
.	.

He	PRP
sometimes	RB
slept	VBD
outside	IN
the	DT
national	JJ
stadium	NN
.	.
